AHEAD	AH HH EH D
BE	B IY
BEHIND	B IH HH AY N D
BEING	B IY IH NG
BUT	B AH T
CAMERA	K AE M ER AH
CAMERA(2)	K AE M R AH
CAR	K AA R
DID	D IH D
FIRST	F ER S T
FRONT	F R AH N T
HOW	HH AW
IN	IH N
INSIDE	IH N S AY D
IS	IH Z
IT	IH T
JARVIS	JH AA R V AH S
JARVIS(2)	JH AA R V IH S
LEFT	L EH F T
NOW	N AW
OF	AH V
ON	AA N
ON(2)	AO N
RIGHT	R AY T
SAY	S EY
STOP	S T AA P
THIS	DH IH S
WHAT	W AH T
WHAT(2)	HH W AH T
WHICH	W IH CH
WHICH(2)	HH W IH CH
WITH	W IH DH
WITH(2)	W IH TH
WORK	W ER K
